#########.............
#&&&&...#......#######
#&&.....########.....#
#...@..............&&#
#.......########.....#
#.......#......#######
#########.............
