#########.............
#&&&&..-#......#######
#&&.....########....$#
#...@...|.........H&&#
#.......########....$#
#.......#......#######
#########.............
