#########.............
#&&&&...#......#######
#&&.....########.....#
#...@.............a&&#
#.......########.....#
#.......#......#######
#########.............
